############################
#                          #
#        P   X             #
#                          #
#          X O X           #
#####                      #####
   #             X             #
    #                          #
    ############################